5
10
DPDDDDDDPD
DPDPPPPDPD
DPDPDDPDPD
DPPPDDPPPD
DDDDDDDDDD